.-.-.-.-.
|       |
.-. . .-.
|       |
.-.-. .-.
|       |
.-. .-. .
|       |
.-.-.-.-.
