.-.-.-.-.
|   |   |
.-.-.-. .
| | | | |
.-.-.-.-.