.-.-.-.-.
|       |
.-. . .-.
|       |
.-.-. .-.
|       |
. . .-.-.
|       |
.-.-.-.-.
